...1111111111...
....22222222....
.....000000.....
..0...1111...0..
..1....22....1..
....22....22....
................
................
................