0000111111110000
0011112222111100
0122222222222110
1111111111111111
2222222222222222
0000000000000000
................
................
................