00...222222...11
.00...2222...11.
..00...22...11..
...00......11...
....00....11....
.....00..11.....
......0011......
................
................